R 1280 800
NO ./textures/bricks.xpm
SO ./textures/bricks.xpm
WE ./textures/bricks.xpm
EA ./textures/bricks.xpm
S ./textures/bricks.xpm
C 153,153,255
F 153,51,51
1111111111111111111111111
1000000000110000000000001
1011000001110000000000001
1001000000000000000000001
1011000N01110000000000001
1000000000110000011111111
111101111111110111
111111111 111111111