R 800 400
NO ./textures/grass.xpm
SO ./textures/bricks.xpm
WE ./textures/wallpaper.xpm
EA ./textures/wood.xpm
S ./textures/bricks.xpm
C 234,178,0
F 70,53,61
1111111111
100W001
1111111