R 800 400
NO ./textures/bricks.xpm
SO ./textures/bricks.xpm
WE ./textures/bricks.xpm
EA ./textures/bricks.xpm
S ./textures/bricks.xpm
C 234,178,204
F 70,53,61
1111111111
1000001111
10S00000001
1000000001
1111111111