R 800 400
NO ./textures/bricks.xpm
SO ./textures/bricks.xpm
WE ./textures/bricks.xpm
EA ./textures/bricks.xpm
S ./textures/bricks.xpm
C 153,153,255
F 153,51,51
111111
100E01
100001
111111