R    400 400
NO      ./textures/stone1.xpm
SO ./textures/stone2.xpm
   WE       ./textures/stone3.xpm
EA    ./textures/stone4.xpm
        S ./sprites/blood.xpm
      F 00,       153,    15

C    255,255,       255



11111111111111111111111111111
10101010101010101010101010101
10001000100010001000100010001
10101010101010101010101010101
10000000100000001000000000001
10101010000000000010101010101
101010101000202000101010101011
10101010100000001010101010101
10000000000000000000000000001
100000001000N0001000000000001
10000000000000000000000000001
10101010100000001010101010101
10101010100000001010101010101
10101010000000000010101010101
10000000100000001000000000001
10101010101010101010101010101
10001000100010001000100010001
10101010101010101010101010101
11111111111111111111111111111