R 900 450
NO ./textures/metro.xpm
SO ./textures/metro.xpm
WE ./textures/metro.xpm
EA ./textures/wood.xpm
S ./textures/wood.xpm
F 182,182,182
C 251,96,127

1111111111111111
1010201010100001 
100010N000002001
1010001010000001 
1010001010100201 
1010001010100001 
1111111111111111