R 100 100
NO ./textures/metro.xpm
SO ./textures/text_stalin.xpm
WE ./textures/wood.xpm
EA ./walls/wall2.xpm
S ./sprites/dead.xpm
C 0,0,255
F 0,255,0
11111111111111111111
100000000000000000001
1000000000000000000001
10000000000020000001111
10000011111000010101
10000010001000000001
100000102010000102011111
100000100010000000000001
100000110110000101010001
111110000000200000000001
    10000000000000000001
    10020N00200000002001
    10000000000000000001
   100000000200000000001
  1000000000000000000001
 10000000000200000000001
111111111000000000000001
110100001000000111111111
1100002010000001
1101000010000001
1101111110000001111
1100000000000000001
1111111110000000001
1111111111111111111