R 2650 1440
NO ./textures/metro.xpm
SO ./textures/metro.xpm
WE ./textures/metro.xpm
EA ./textures/metro.xpm
S ./textures/wood.xpm
F 182,182,182
C 251,96,127

1111111111111111111111111111111
1010101010101 10101010101010101
1000100010001 10001000100010001
1010101010101110101010101010111
10000000100000001000000000001
10101010000000000010101010101
10101010100000001010101010101
10101010100000001010101010101
10000000000000000000000000001
100000001000S0001000000000001
10000000000000000000000000001
10101010100000001010101010101
10101010100000001010101010101
10101010000000000010101010101
10000000100000001000000000001
10101010101010101010101010101
10001000100010001000100010001
10101010101010101010101010101
11111111111111111111111111111