R 1000 800
NO ./textures/text_stalin.xpm
SO ./textures/text_stalin.xpm
WE ./textures/text_stalin.xpm
EA ./textures/text_stalin.xpm
S ./sprites/pilar.xpm
F 112,112,112
C 56,56,56
111111111111111111111111
100000102010000102000001
100000102000000002000001
100000102011111111111111
10000000001            
10000011111            
10000000001            
10020010201
100000100011111111111111
100200110000000101010001
111111111111100000000001
            100020000001
            100000002001
            100000000001
            100002000001
111111111111100000000001
110000000000200000N00001
111111111000000000000001
111111111111111111111111
